########################
#                      #
#                      #
###################    #
#                      #
#   ####################
#                      #
#                      #
#                      #
#         #            #
#         #            #
#         #            #
#         #            #
########################
