########################
#                     ##
##################### ##
##################### ##
#                     ##
#  #####################
#  # # #################
#  ## ###             ##
#  # ## # ########### ##
#  ### ## ## # # #### ##
#  # ## # # # # #     ##
#  ###### #######   ####
#         #         ####
########################
